# ############################
#                #    ##    ##
# ####### ######## ##    ## ##
#     #        # # ###########
# ### # ###### # #           #
# ###   ###### # ########### #
# #######      # #         # #
#  ########### # # ## #### # #
## #           # # ## #    # #
#  # ############# ## # #### #
#### ####          ## #     ##
##   ##   ########### ##### ##
## #### ##   ##       ##### ##
## #### ## # ## ########### ##
## ####    #    #           ##
##      ######### ############
# ##### ##        ##         #
# ##### ## ######### ####### #
#    ## ## ### ##### #       #
#######  # ###       # ##### #
#    ##  # ##### #####     # #
#  # ##  # #     ########### #
####  # ## # ### #           #
#####   ## # ### # ###########
####### ## # ### # ###      ##
##      ## # # # # ### #### ##
####### ## # # ### ### #  # ##
#######  # # # #         ## ##
#        #   #   # ########  #
############################ #
